1111111111111111111111111111111111
1110C0000000C00C0000C00000P00CE011
1001011111111111111111111111111111
1111111111111111111111111111111111
