1111111111111111111111111111111111
111E00000000000C00000C000000000001
1111111110100000101001000000010101
1010010010101010001001000000010111
1P0000000C00C000000000000000000C11
1111111111111111111111111111111111
